[
    [1, 1, 1, 1, 1, 1, 1, 1, 1, 1, 1, 1, 1, 1, 1],
    [1, 2, 2, 2, 2, 7, 2, 2, 2, 2, 2, 2, 2, 2, 1],
    [1, 2, 2, 2, 5, 7, 2, 2, 2, 2, 2, 2, 2, 2, 1],
    [1, 2, 2, 2, 1, 1, 2, 1, 1, 2, 2, 2, 2, 2, 1],
    [1, 1, 2, 1, 1, 1, 1, 1, 1, 1, 1, 1, 1, 1, 1],
    [1, 2, 2, 2, 1, 2, 2, 3, 2, 2, 2, 2, 2, 2, 1],
    [1, 2, 2, 2, 2, 2, 7, 2, 2, 1, 2, 2, 2, 2, 1],
    [1, 1, 1, 1, 1, 1, 1, 2, 1, 1, 1, 1, 1, 1, 1],
    [1, 2, 2, 2, 1, 1, 7, 1, 1, 1, 2, 2, 2, 2, 1],
    [1, 2, 2, 2, 2, 2, 2, 2, 2, 2, 2, 2, 2, 2, 1],
    [1, 1, 1, 1, 1, 1, 1, 1, 1, 1, 1, 1, 1, 1, 1]
]